0000000000000000000000000000000000000000000000
0000000000000000000000000000000000000000000000
0000000000000000000000000000000000000000000000
0000000000000000000000000000000000000000000000
0000000000000000000000000000000000000000000000
0000000000500000000005000000000000000000000000
1111111111000111111222222221111133111111111411
0000000000000000001222222221000133100000001110
0000000000000000001222222221000133100000000000
0000000000000000001222222221000133100000000000
0000000000000000001111111111000111100000000000